SO ./texture/SO.xpm
NO ./texture/NO.xpm                            
WE ./texture/WE.xpm
EA ./texture/EA.xpm

F 54,69,79
C 145,200,228


 1111111111111111111111111111
    1000000000110000000000001
    1011000001110000000000001
    1001000000000000000000001111
111111111011000001110000000000001
100000000011000001110111111111111
11110111111111011100000010001
11110111111111011101010010001
11000000110101011100000010001
10000000S00000001100000010001
10000000000000001101010010001
1100000111010101111101111000111
11110111 1110101 101111010001
11111111 1111111  111111111111